*********
* **** S*
*R   * **
* ** * **
*  A    *
* * *** *
* * *** *
* *    R*
*********