***********
*A        *
* * * *R  *
* *    ** *
*  R**    *
** *   * **
*    **R  *
* **    * *
*  R* * * *
*        S*
***********