*********
*R****  *
*A   * **
*S** * **
*       *
* * *** *
* * *** *
* *    R*
*********