*********
*R**** S*
*    * **
* ** * **
*  A    *
* * *** *
* * *** *
* *    R*
*********