*********
* ** S<R*
*R** ** *
*  <    *
**** ****
**  A> **
**^***R**
**     **
*********