*********
*   R <A*
* *v***v*
*    R* *
*** * <R*
**  * * *
** ** * *
*S **   *
*********