*********
*R  >  S*
* * * *^*
* * * * *
* *R< > *
*   *** *
**^**R  *
*A >    *
*********