*********
*R <A> R*
* **^** *
*  * *  *
** * * **
*  < >  *
*v** **v*
*   S   *
*********