*******
*  <A *
*R***R*
*   S>*
*******