***********
*         *
* * * * * *
*  R   R  *
* * * * * *
*   AS    *
* * * * * *
*  R   R  *
* * * * * *
*         *
***********