*******
*  R S*
* * * *
*    R*
* * * *
*A    *
*******