***********
*         *
* ** * ** *
* *R   R* *
*   * *   *
**  A S  **
*   * *   *
* *R   R* *
* ** * ** *
*         *
***********