*******
*  <A>*
*R***R*
*  <S>*
*******