***********
*A        *
* * * *   *
* *    ** *
*  R**    *
** *   * **
*    **   *
* **    * *
*   * * * *
*        S*
***********