************
*A > >   >R*
* **v***v* *
*v*   **R*^*
* > * ** < *
*v*   R ** *
* ***R*^** *
* *** <  *^*
* >R **  < *
*v**^***^*^*
*R <     <S*
************