*********
*S> >  R*
*v*v*v* *
* >R  > *
*v* * *^*
* <  R< *
* *^*^*^*
*R  < <A*
*********


