************
*S>  > > >R*
*v**v*v*v*^*
* ** *  R< *
* >  > * *^*
*v**v*R  < *
* >  R*^**^*
*v* * <  < *
* >R  * ** *
*v*^*^*^**^*
*R< < <  <A*
************