*********
*S> >  R*
*v*v*v* *
* > R < *
* *^*^*^*
*R  < <A*
*********


