*********
*S     R*
* * * * *
*  R*R  *
* * * * *
*R     A*
*********