*********
*S>  > R*
*v**v**^*
* ** R< *
* > *** *
*v*R***^*
* *^*** *
*R<  < A*
*********